■■■■■■■■■■■■■■■■■■■■■■■■■■■■■■■■■■■■■■■
■■■■■■■■■■■■■■■■■■□S□■■■■■■■■■■■■■■■■■■
■■■■■■■■■■■■■■■■■■□□□■■■■■■■■■■■■■■■■■■
■■■■■■■■■■■■■■■■■■□□□■■■■■■■■■■■■■■■■■■
■■■■■■■■■■■■■■■■■■□□□■■■■■■■■■■■■■■■■■■
■■■■■■■■■■■■■■■■■■□□□■■■■■■■■■■■■■■■■■■
■■■■■■■■■■■■■■■■■■□□□■■■■■■■■■■■■■■■■■■
■■■■■■■■■■■■■■■■■■□□□■■■■■■■■■■■■■■■■■■
■■■■■■■■■■■■■■■■■■□□□■■■■■■■■■■■■■■■■■■
■■■■■■■■■■■■■■■■■■□□□■■■■■■■■■■■■■■■■■■
■■■■■■■■■■■■■■■■■■□□□■■■■■■■■■■■■■■■■■■
■■■■■■■■■■■■■■■■■■□□□■■■■■■■■■■■■■■■■■■
■■■■■■■■■■■■■■■■■■□□□■■■■■■■■■■■■■■■■■■
■■■■■■■■■■■■■■■■■■□□□■■■■■■■■■■■■■■■■■■
■■■■■■■■■■■■■■■■■■□□□■■■■■■■■■■■■■■■■■■
■■■■■■■■■■■■■■■■■■□□□■■■■■■■■■■■■■■■■■■
■■■■■■■■■■■■■■■■■■□□□■■■■■■■■■■■■■■■■■■
■■■■■■■■■■■■■■■■■■□□□■■■■■■■■■■■■■■■■■■
■■■■■■■■■■■■■■■■■■□□□■■■■■■■■■■■■■■■■■■
■■■■■■■■■■■■■■■■■■□b□■■■■■■■■■■■■■■■■■■
■■■■■■■■■■■■■■■■■■□E□■■■■■■■■■■■■■■■■■■
■■■■■■■■■■■■■■■■■■■■■■■■■■■■■■■■■■■■■■■