■■■■■■■■■■■■■■■■■■■■■■■■■■■■■■■■■■■■■■■
■■■■■■■■■■■■■■■■■■■■■■■■■■■■■■■■■■■■■■■
■■■■■■■■■■■■■■■■■■■■■■■■■■■■■■■■■■■■■■■
■■■■■■■■■■■■■■■■■■■■■■■■■■■■■■■■■■■■■■■
■■■■■■■■■■■■■■■■■■■■■■■■■■■■■■■■■■■■■■■
■■■■■■□□□□□□□□□□□□□□□■■■■■■■■■■■■■■■■■■
■■■■■■S□□□□□□□□□□□□□□■■■■■■■■■■■■■■■■■■
■■■■■■■■■■■■■■■■■■□□□■■■■■■■■■■■■■■■■■■
■■■■■■■■■■■■■■■■■■□□□■■■■■■■■■■■■■■■■■■
■■■■■■■■■■■■■■■■■■□□□■■■■■■■■■■■■■■■■■■
■■■■■■■■■■■■■■■■■■□□□■■■■■■■■■■■■■■■■■■
■■■■■■■■■■■■■■■■■■□□□■■■■■■■■■■■■■■■■■■
■■■■■■■■■■■■■■■■■■□□□■■■■■■■■■■■■■■■■■■
■■■■■■■■■■■■■■■■■■□b□■■■■■■■■■■■■■■■■■■
■■■■■■■■■■■■■■■■■■□□□■■■■■■■■■■■■■■■■■■
■■■■■■■■■■■■■■■■■■□□□□□□□□□□□□□□□■■■■■■
■■■■■■■■■■■■■■■■■■□□□□□□□□□□□□□□E■■■■■■
■■■■■■■■■■■■■■■■■■■■■■■■■■■■■■■■■■■■■■■
■■■■■■■■■■■■■■■■■■■■■■■■■■■■■■■■■■■■■■■
■■■■■■■■■■■■■■■■■■■■■■■■■■■■■■■■■■■■■■■
■■■■■■■■■■■■■■■■■■■■■■■■■■■■■■■■■■■■■■■
■■■■■■■■■■■■■■■■■■■■■■■■■■■■■■■■■■■■■■■