■■■■■■■■■■■■■■■■■■■■■■■■■■■■■■
■□□□□□□□□□□□□□□□□■■■■■■■■■■■■■
■S□□□□□□□□□□□□□□□■■■■■■■■■■■■■
■■■■■■■■■■■■■□□□□■■■■■■■■■■■■■
■■■■■■■■■■■■■□□□□■■■■■■■■■■■■■
■■■■■■■■■■■■■□□□□■■■■■■■■■■■■■
■■■■■■■■■■■■■□□□□■■■■■■■■■■■■■
■■■■■■■■■■■■■□□□□■■■■■■■■■■■■■
■■■■■■■■■■■■■□□□□■■■■■■■■■■■■■
■■■■■■■■■■■■■□□□□■■■■■■■■■■■■■
■■■■■■■■■■■■■□□□□■■■■■■■■■■■■■
■■■■■■■■■■■■■□□□□□□□□□□□□□□□□■
■■■■■■■■■■■■■□□□□□□□□□□□□□□□E■
■■■■■■■■■■■■■■■■■■■■■■■■■■■■■■
