■■■■■■■■■■■■■■■■■■■■■■■■■■■■■■■■■■■■■■■
■■■■■■■■■■■■■■■■■■■■■■■■■■■■■■■■■■■■■■■
■□□□□□□□□□□□□□□□□□□□□□□□□□□□□□□□□□□□□□■
■□□□□□□□□□□□□□□□□□□□□□□□□□□□□□□□□□□□□□■
■□□□□□□□□□□□□□□□□□□□□□□□□□□□□□□□□□□□□□■
■□□□□□□□□□□□□□□□□□□□□□□□□□□□□□□□□□□□□□■
■□□□□□□□□□□□□□□□□□□□□□□□□□□□□□□□□□□□□□■
■□□□□□□□□□□□□□□□□□□□□□□□□□□□□□□□□□□□□□■
■□□□□□□□□□□□□□□□□□□□□□□□□□□□□□□□□□□□□□■
■□□□□□□□□□□□□□□□□□□□□□□□□□□□□□□□□□□□□□■
■□□□□□□□□□□□□□□□□□□□□□□□□□□□□□□□□□□□□□■
WS□□□□□□□□□□□□□▦□□□□□□□□□□□□□□□□b□□□□EW
■■■■■■■■■■■■■■■■■■■■■■■■■■■■■■■■■■■■■■■
■■■■■■■■■■■■■■■■■■■■■■■■■■■■■■■■■■■■■■■
■■■■■■■■■■■■■■■■■■■■■■■■■■■■■■■■■■■■■■■
■■■■■■■■■■■■■■■■■■■■■■■■■■■■■■■■■■■■■■■
■■■■■■■■■■■■■■■■■■■■■■■■■■■■■■■■■■■■■■■
■■■■■■■■■■■■■■■■■■■■■■■■■■■■■■■■■■■■■■■
■■■■■■■■■■■■■■■■■■■■■■■■■■■■■■■■■■■■■■■
■■■■■■■■■■■■■■■■■■■■■■■■■■■■■■■■■■■■■■■
■■■■■■■■■■■■■■■■■■■■■■■■■■■■■■■■■■■■■■■
■■■■■■■■■■■■■■■■■■■■■■■■■■■■■■■■■■■■■■■