■■■■■■■■■■■■■■■■■■■■■■■■■■■■■■■■■■■■■■■
■■■■■■■■■■■■■■■■■■■■■■■■■■■■■■■■■■■■■■■
■□□□□□□□□□□□□□□□□□□□□□□□□□□□□□□□□□□□□□■
■□□□□□□□□□□□□□□□□□□□□□□□□□□□□□□□□□□□□□■
■□□□□□□□□□□□□□□□□□□□□□□□□□□□□□□□□□□□□□■
■□□□□□□□□□□□□□□□□□□□□□□□□□□□□□□□□b□□□E■
■□□□□□□□□□□■■■■■■■■■■■■■■■■■■■■■■■■■■■■
■□□□□□□□□□□□□□□□□□□□□□□□□□□□□□□□□□□□□□■
■□□□□□□□□□□□□□□□□□▤□□□□□□□□□▦□□□□□□□□□■
■□□□□□□□□■■■■■■■■■■■■■■■■■■■■■■■■■■■■■■
■□□□□□□□□□□□□□□□□□□□□□□□□□□□□□□□□□□□□□■
■S□□□□□□□□□□□□□□□▤□□□□□□▤□□□□□□□□□□□□□■
■□□□□□□■■■■■■■■■■■■■■■■■■■■■■■■■■■■■■■■
■□□□□□□□□□□□□□□□□□□□□□□□□□□□□□□□□□□□□□■
■□□□□□□□□□□□□□□▦□□□□□□□□□□□□□▦□□□□□□□□■
■□□□□■■■■■■■■■■■■■■■■■■■■■■■■■■■■■■■■■■
■□□□□□□□□□□□□□□□□□□□□□□□□□□□□□□□□□□□□□■
■□□□□□□□□□□□□□□□□□▤□□□□□□□□□□□□□□□□□□□■
■□□■■■■■■■■■■■■■■■■■■■■■■■■■■■■■■■■■■■■
■□□□□□□□□□□□□□□□□□□□□□□□□□□□□□□□□□□□□□■
■□□□□□□□□□□□□□□□□□□□□□□□□□□▦□□□□□□□□□□■
■■■■■■■■■■■■■■■■■■■■■■■■■■■■■■■■■■■■■■■