■■■■■■■■■■■■■■■■■■■■■■■■■■■■■■■■■■■■■■■
■■■■■■■■■■■■■■■■■■■■■■■■■■■■■■■■■■■■■■■
■■■■■■■■■■■■■■■■■■■■■■■■■■■■■■■■■■■■■■■
■■■■■■■■■■■■■■■■■■■■■■■■■■■■■■■■■■■■■■■
■■■■■■■■■■■■■■■■■■■■■■■■■■■■■■■■■■■■■■■
■■■■■■■■■■■■■■■■■■■■■■■■■■■■■■■■■■■■■■■
■■■■■■■■■■■■■■■■■■■■■■■■■■■■■■■■■■■■■■■
■■■■■■■■■■■■■■■■■■■■■■■■■■■■■■■■■■■■■■■
■■■■■■■■■■■■■■■■■■■■■■■■■■■■■■■■■■■■■■■
■■■■■■■■■■■■■■■■■■■■■■■■■■■■■■■■■■■■■■■
■■■■■■■■■■■■■■■■■■■■■■■■■■■■■■■■■■■■■■■
■□□□□□□□□□□□□□□□□□□□□□□□□□□□□□□□□□□□□□■
■□□□□□□□□□□□□□□□□□□□□□□□□□□□□□□□□□□□□□■
■□□□□□□□□□□□□□□□□□□□□□□□□□□□□□□□□□□□□□■
■□□□□□□□□□□□□□□□□□□□□□□□□□□□□□□□□□□□□□■
■□□□□□□□□□□□□□□□□□□□□□□□□□□□□□□□□□□□□□■
■□□□□□□□□□□□□□□□□□□□□□□□□□□□□□□□□□□□□□■
■□□□□□□□□□□□□□□□□□□□□□□□□□□□□□□□□□□□□□■
■□□□□□□□□□□□□□□□□□□□□□□□□□□□□□□□□□□□□□■
■□□□□□□□□□□□□□□□□□□□□□□□□□□□□□□□□□□□□□■
■E□□□□□□□□□□s□□□□□□b□□□□□□S□□□□□□□□□□e■
■■■■■■■■■■■■■■■■■■■■■■■■■■■■■■■■■■■■■■■